{
  "turns": 50,
  "layout": [
    "                         ",
    "                         ",
    "                         ",
    "                         ",
    "                         ",
    "                         ",
    "                         ",
    "                         ",
    "                         ",
    "                         ",
    "                         ",
    "                         ",
    "                         ",
    "                         ",
    "                         ",
    "                         ",
    "                         ",
    "                         ",
    "                         ",
    "                         ",
    "                         ",
    "     ####### #######     ",
    "     #             #     ",
    "     # ## ##### ## #     ",
    "     #sa#  MUM  #as#     "
  ],
  "units": {
    "M": "monkey",
    "s": "song",
    "a": "album",
    "p": "playlist",
    "U": "user",
    "#": "wall",
    " ": "empty",
    "_": "empty",
    "-": "empty"
  }
}
